11111111111
100C000FE11
10111000001
1P0000000C1
11111111111
