111111111111111
1C01000FF0000C1
1F0001000011111
1011110P0000001
10111F0000F0F01
1C00000000FCFE1
111111111111111
