1111111
100CE11
1P000D1
1111111
