1111111
100CPE1
1000000
1111111
