1111111
100CPE1
1000001
1110111
