1111111
100CP01
1000001
1111111
