1111111
100C0E1
1000001
1111111
