1111111
100CPE1
1000001
111111
