11111111111111
1P000C00000001
1C000011100001
1111101C000001
10000C11111101
10111110000001
1000C11E0000C1
11111111111111
