11111111111111
10000C00P00001
1C000011100001
1111101C000001
10000C11111101
10111110000001
1000C11E0000C1
11111111111111
